+-----------------------------------------+
| .   .   .   .   .   .   .   .   .   .   |
|                                         |
| .   .   .   .   .   .   .   .   .   .   |
|                                         |
| .   .   .   .   .   .   .   .   .   .   |
|                   +-----------+         |
| .   .   .   .   . | .   .   . | .   .   |
|   +---+           |           |         |
| . | . | .   .   . | .   .   . | .   .   |
|   |   |           |           |         |
| . | . | .   .   . | .   .   . | .   .   |
|   |   |           |           |         |
+---+---+-----------+-----------+---------+

{}
{(1;1)}
